...................
...................
..###############..
..#...kb#.#.#...#..
..#...#b..#.....#..
..##...c.h..#...#..
..##.c.@..#..#..#..
..##..#k.h......#..
..#..b..h....#..#..
..#.#.b.#.#.....#..
..#.......#.....#..
..#.#....db#....#..
..#.##b#........#..
..###############..
...................
...................