..b####b###b.
##b...##b...#
#...b.....#.#
#bkbb####.#.#
##b##@..#.b.b
#...b##...#.#
bb#...bb..#.#
.#.b###bb#..#
.b.b....b#.b#
.#...b#.....d
.#b#b#b######